################
#......t.......#
#......c.......#
#.....(%)......#
#.....(%)...####
#.....(%).......
#.....(%)...####
#.....(%)......#
#..t..(%)...tt.#
#..c..(%)...cc.#
#%%%%%%%%%%%%%%#
################