Castelo do Bowser
sfx/castelo.mid
gfx/fundo3.bmp
3
40 14
0 2 1
1 2 2 2 2 2
0 160

   0    0    0    0    0    0    0    0    0    0    0    0    0    0    0    0    0    0    0    0   0    0    0    0    0    0    0    0    0    0    0    0    0    0    0    0    0    0    0    0
   0    0    0    0    0    0    0    0    0    0    0    0    0    0    0    0    0    0    0    0   0    0    0    0    0    0    0    0    0    0    0    0    0    0    0    0    0    0    0    0
   0    0    0    0    0    0    0    0    0    0    0    0    0    0    0    0    0    0    0    0   0    0    0    0    0    0    0    0    0    0    0    0    0    0    0    0    0    0    0    0
   0    0    0    0    0    0    0    0    0    0    0    0    0    0    0    0    0    0    0    0   0    0    0    0    0    0    0    0    0    0    0    0    0    0    0    0    0    0    0    0
   0    0    0    0    0    0    0    0    0    0    0    0    0    0    0    0    0    0    0    0   0    0    0    0    0    0    0    0    0    0    0    0    0    0    0    0    0    0    0    0
   0    0    0    0    0    0    0    0    0    0    0    0    0    0    0    0    0    0    0    0   0    0    0    0    0    0    0    0    0    0    0    0    0    0    0    0    0    0    0    0
   0    0    0    0    0    0    0    0    0    0    0    0    0    0    0    0    0    0    0    0   0    0    0    0    0    0    0    0    0    0    0    0    0    0    0    0    0    0    0    0
   0    0    0    0    0    0    0    0    0    0    0    0    0    0    0    0    0    0    0    0   0    0    0    0    0    0    0    0    0    0    0    0    0    0    0    0    0    0    0    0
   0    0    0    0    0    0    0    0    0    0    0    0    0    0    0    0    0    0    0    0   0    0    0    0    0    0    0    0    0    0    0    0    0    0    0    0    0    0    0    0
   0    0    0    0    0    0    0    0    0    0    0    0    0    0    0    0    0    0    0    0   0    0    0    0    0    0    0    0    0    0    0    0    0    0    0    0    0    0    0    0
   0    0    0    0    0    0    0    0    0    0    0    0    0    0    0    0    0    0    0    0   0    0    0    0    0    0    0    0    0    0    0    0    0    0    0    0    0    0    0    0
   0    0    0    0    0    0    0    0    0    0    0    0    0    0    0    0    0    0    0    0   0    0    0    0    0    0    0    0    0    0    0    0    0    0    0    0    0    0    0    0
   0    0    0    0    0    0    0    0    0    0    0    0    0    0    0    0    0    0    0    0   0    0    0    0    0    0    0    0    0    0    0    0    0    0    0    0    0    0    0    0
   0    0    0    0    0    0    0    0    0    0    0    0    0    0    0    0    0    0    0    0   0    0    0    0    0    0    0    0    0    0    0    0    0    0    0    0    0    0    0    0

   0   21   24   23   22   21   24   23   22    0    0    0    0    0    0    0    0    0    0    0   0    0    0    0    0    0    0    0    0    0    0    0    0   21   24   22   23   22   21    0
   0   22   21   24   23   22   21   24   23   30    0    0    0    0    0    0    0    0    0    0   0    0    0    0    0    0    0    0    0    0    0    0    0   23   21   24   21   23   24    0
   0   23   22   21   24   23   22   21   24    0    0    0    0    0    0    0    0    0    0    0   0    0    0    0    0    0    0    0    0    0    0    0    0   22   24   21   22   24   21    0
   0    0    0    0    0    0    0    0    0    0    0    0    0    0    0    0    0    0    0    0   0    0    0    0    0    0    0    0    0    0    0    0    0   24   23   22   21   23   22    0
   0    0    0    0    0    0    0    0    0    0    0    0    0    0    0    0    0    0    0    0   0    0    0    0    0    0    0    0    0    0    0    0    0   23   24    0    0   24   23    0
   0    0    0    0    0    0    0    0    0    0    0    0    0    0    0    0    0    0    0    0   0    0    0    0    0    0    0    0    0    0    0    0    0   22   21    0    0   22   24    0
   0    0    0    0    0    0    0    0    0    0    0    0    0    0    0    0    0    0    0    0   0    0    0    0    0    0    0  127    0    0    0    0    0    0    0    0    0    0    0    0
   0    0    0    0    0    0    0    0    0    0    0    0    0    0    0    0    0    0    0    0   0    0    0    0    0    0    0    0    0    0    0    0    0    0    0    0    0    0    0    0
   0    0    0    0    0    0    0    0    0    0    0    0    0    0    0    0    0    0    0    0   0    0    0    0    0    0    0    0    0    0    0    0    0    0    0    0    0    0    0    0
   0    0    0    0    0    0    0    0    0    0    0    0    0    0    0    0    0    0    0    0   0    0    0    0    0    0    0    0    0    0    0    0   30    0    0    0    0    0    0    0
   0    0    0    0    0    0    0    0    0    0    0    0    0    0    0    0    0    0    0    0   0    0    0    0    0    0    0    0    0    0    0    0    0    0    0    0    0    0    0    0
   0    0    0    0    0    0    0    0    0    0    0    0    0    0    0    0    0    0    0    0   0    0    0    0    0    0    0    0    0    0    0    0    0    0    0    0    0    0    0    0
   0    0    0    0    0    0    0    0    0  116    0  116    0  116    0  116    0    0    0    0   0    0    0    0    0    0    0    0    0    0    0    0    0    0    0    0    0    0    0    0
   0    0    0    0    0    0    0    0    0    0    0    0    0    0    0    0    0    0    0    0   0    0    0    0    0    0    0    0    0    0    0    0    0    0    0    0    0    0    0    0

  80    0    0    0    0    0    0    0    0    0    0    0    0    0    0    0    0    0    0    0   0    0    0    0    0    0    0    0    0    0    0    0    5    0    0    0    0    0    0    5
  80    0    0    0    0    0    0    0    0    0    0    0    0    0    0    0    0    0    0    0   0    0    0    0    0    0    0    0    0    0    0    0    5    0    0    0    0    0    0    5
  80    0    0    0    0    0    0    0    0   80    0    0    0    0    0    0    0    0    0    0   0    0    0    0    0    0    0    0    0    0    0    0    5    0    0    0    0    0    0    5
  80   80   80   80   80   80   80   80   80    0    0    0   80    0    0    0    0    0    0    0   0    0    0    0    0    0    0    0    0    0    0    0    5    0    0    0    0    0    0    5
   0    0    0    0    0    0    0    0    0    0    0    0    0    0    0    0    0    0    0    0   0    0    0    0    0    0    0    0    0    0    0    0    5    0    0 8484 8485    0    0    5
   0    0    0    0    0    0    0    0    0    0    0    0    0    0    0    0    0    0    0    0   0    0    0    0    0    0    0    0    0    0    0    0    5    0    0   38   39    0    0    5
   0    0    0    0    0    0    0    0    0    0    0    0    0    0    0   80    0    0    0    0   0    0    0   83    0    0    0    0   84    0    0    0    5    5    5    5    5    5    5    5
   0    0    0    0    0    0    0    0    0    0    0    0    0    0    0    0    0    0    0    0   0    0    0    0   84   81   82   83    0    0    0    0    0    0    0    0    0    0    0    0
   0    0    0    0    0    0    0    0    0    0    0    0    0    0    0    0    0    0    0    0   0    0    0    0    0    0    0    0    0    0    0    0    0    0    0    0    0    0    0    0
   0 2561    0    0 4644 4645    0    0    0    0    0    0    0   80    0    0    0    0    0    0   0    0    0    0    0    0    0    0    0    0   83    0    0    0    0   81    0    0    0    0
   0    0    0    0   38   39    0    0    0    0    0    0    0    0    0    0    0    0    0    0   0    0    0    0    0    0    0    0    0    0    0   81   82   84   83    0    0    0   11    0
   0    0    0    0   38   39    0    0  115    0    0    0    0    0    0    0  115    0    0    0 115    0    0    0    0    0    0    0    0    0    0    0    0    0    0    0    0    0  120    0
 101  102  102  102  102  102  102  103  115  110  109  111  113  112  110  109  115   74   74   74 115  101  102  102  102  102  102  102  102  103    0    0    0    0    0    0  101  102  102  103
 106  107  107  107  107  107  107  108  115  114  114  114  114  114  114  114  115   73   73   73 115  106  107  107  107  107  107  107  107  108    0    0    0    0    0    0  106  107  107  108
